0 0 0 0  0 0     0     0 0  0 0 1 1 1 1
0 1 1 1  1 t'0   t'0   1 c! 1 1 1 1 s 1
0 1 1 1  1 0     0     0 0  0 0 0 1 1 1
0 1 1 c@ 1 0     0     0 0  0 0 0 0 0 0
0 1 1 1  1 0     0     0 0  0 0 0 0 0 0
0 0 0 1  1 1     c#    1 1  1 1 1 1 0 0
0 0 0 0  0 0     0     0 0  0 1 1 1 1 c@
1 1 1 0  0 0     0     0 0  0 1 1 1 1 1
1 h 1 1  1 t'123 t'123 1 1  1 1 1 1 0 0
1 1 1 1  0 0     0     0 0  0 0 0 0 0 0