0 0 0 0 0   0   1 1 1 1 0   0   1 1 1
1 1 1 1 0   0   1 1 x 1 0   0   1 h 1
1 1 c 1 0   0   1 1 1 1 0   0   1 1 1
1 1 1 1 0   0   1 1 1 1 0   0   1 1 1
1 s 1 1 0c1 0c1 1 1 1 1 0x0 0x0 1 1 1
1 1 1 1 0   0   1 1 1 1 0   0   0 0 0