1110000000
1111110000
1111111110
0111111111
0000011911
0000001110