0 0 0 w w w w w w w 0 0 0 0
0 0 0 w w w w w w w 0 0 0 0
1 1 1 1 0 0 0 0 0 1 1 1 0 0
1 1 1 0 0 0 0 0 0 0 1 1 0 0
1 1 1 0 0 0 0 0 0 0 1 1 0 0
1 s 1 0 0 1 1 1 1 w w w w w
1 1 1 0 0 1 1 1 1 w w w w w
0 0 0 0 0 1 h 1 0 0 w w 1 w
0 0 0 0 0 1 1 1 0 0 w w w w 